****#***************######**************
*......................................*
#......................................#
#......................................#
*......................................*
*......................................*
*......................................*
#......................................#
*......................................*
*......................................*
*......................................*
*......................................*
*......................................*
#......................................#
*......................................*
*......................................*
*......................................*
*......................................*
#......................................#
*......................................*
*......................................*
*......................................*
*......................................*
*......................................*
*......................................*
#......................................#
*......................................*
*......................................*
*......................................*
*......................................*
*......................................*
*......................................*
*......................................*
*......................................*
*......................................*
*......................................*
*......................................*
*......................................*
*......................................*
****#***************######**************