****************************************
*......................................*
*......................................#
*......................................*
*......................................*
*......................................*
*......................................*
*......................................#
*......................................*
*......................................*
*......................................*
*......................................*
*......................................*
*......................................#
*......................................*
*......................................*
*......................................*
*......................................*
#......................................#
*......................................*
*......................................*
*......................................*
*......................................*
*......................................*
*......................................*
*......................................#
*......................................*
*......................................*
*......................................*
*......................................*
*......................................*
*......................................*
*......................................*
*......................................*
*......................................*
*......................................*
*......................................*
*......................................*
*......................................*
****************************************